xxxxxxxxxxxxxxxx
x x            x
x x            x
x x            x
x x            x
x x  xv        x
x xvv vxxxxx   x
x  s          vx
x vvvvvv vvvv vx
xv      svf   vx
xvvsvvvsvvvvvv x
xxxxxxxxxxxxxxxx
